-......
...........
*...*.....*
..*........
...........
.......*...
...........
.......*...
...........
.*.*.....**
...........
...........
*.....*....
...........
...........
.....*.....
*..........
...........
*......*...
....*......
.........*.
...........
.*.........
.........*.
...........
...*.*.....
.........*.
.*.........
...........
.....*.....
...........
...*...*...
...........
.........*.
...........
..*........
...........
....*...*..
...........
..*......*.
...........
.....*.....
...*.......
.........*.
.....*.....
...........
...*.......
......*....
...........
..........*
...*..*....
...........
...........
......*....
...........
...........
.*..*..*...
...........
...........
.........*.
.....*.....
..........*
..*........
......*....
...........
...........
..*...*..*.
...........
...........
....*......
...........
.......*...
...*.......
...........
......*....
*..........
...........
..*.....*..
...........
......*....
...........
...........
...........
....*.....*
...........
...........
...*...*...
...*.......
.......*...
...........
...........
..*...*....
........*..
...........
..*...*....
........*..
...........
....*......
...........
...*.......
..........*
...........
.....*.....
...*.......
..........
.......*...
.*.........
.......*...
...........
...*.......
...........
........*..
....*......
...........
...........
...*..*....
...........
........*..
*....*.....
...........
...........
...*...*...
...........
.....*.....
...........
..*..*.....
........*..
...........
.....*..*..
...*.......
...........
.....*.....
...........
...........
.......*...
...*......*
...........
........*..
....*......
...........
.......*...
*....*.....
........*..
.....*.....
..*........
...........
...........
.*...*.....
...........
...*.......
...........
......*...*
...........
......*....
*..........
........*..
..........
.....*...*.
...........
.......*...
...........
.....*.....
.........*.
...*......*
...........
......*....
...........
...*...*...
...........
..*....*...
...........
*.....*....
...........
...........
....*......
...........
..*....*...
...........
..*........
...........
....*.....*
*..........
....*......
........*..
...........
...........
...*..*.*..
...........
......*...*
..*........
.........*.
...*.......
...........
.......*...
...........
....*......
......*....
*..........
...........
.......*...
...*.......
...........
...........
.....*...