-......
..*...*.*..
*...*..*..*
..*........
...........
....*..*...
.*.........
.......*...
...........
.*.*.....**
.....*.....
...........
*.....*....
...*......*
...........
.....*.....
*..*.....*.
...........
*......*...
....*......
.........*.
....*..*...
.*.........
.....*...*.
...........
...*.*.....
.........*.
.*...*....*
...........
..*..*.....
...........
*****..*...
...........
......*.**.
...........
..*...*....
...........
....*...*..
...........
.**...*..*.
...........
.....*.....
...*.......
..*...*..*.
.*...*.*...
.....*.....
...*.....*.
..*...*..*.
*....*.....
..*........*
...*..*....
...*.......
....*......
*.....*..*.
....*......
.........*.
.*..*..*...
..*.....*..
....*......
..*....*.*.
.....*..*..
*.....*...*
..*........
..*...*..*.
.....*.....
....*......
..*...*..*.
..*..*...*.
.......*...
....*......
...........
.......*...
...*....*..
...........
......*....
*.....*....
...........
..*.....*..
...........
..*...*....
*...*....*.
..*........
.......*...
....*.....*
...*...*...
...........
...*...*...
...*.......
*..*...*...
.....*.....
...........
..*...*....
....*...*..
...........
..*...*....
........*..
.......*...
....*......
........*..
...*.......
*.....*...*
...........
.....*.....
...*....*..
....*.....
.......*...
.*.*.......
.......*...
......*....
...*......*
....*......
.*......*..
....*......
..*....*...
...........
...*..*....
..*.......*
...*....*..
*....*.....
..*...*....
...........
...*...*...
...........
.*...*...*.
...........
..*..*.....
....*...*..
..*........
.....*..*..
...*.......
........*..
...*.*.....
.....*.....
..*......*.
.......*...
...*......*
.....*.....
........*..
....*...*..
..*........
.......*...
*....*.....
........*..
.....*.....
..*...*....
....*..*...
........*..
.*...*.....
.......*...
...*..*....
...*.......
......*...*
..*........
......*....
*.*........
....*...*..
..*.......
.....*...*.
...*.......
.......*...
...*.......
.....*.....
..*......*.
...*......*
...........
.*....*....
...........
...*...*...
.....*.....
..*....*...
...........
*.....*....
....*.....*
.......*...
*...*...*..
...........
..*....*...
...........
..*....*...
...........
....*.....*
*..........
....*......
...*.*..*..
...*.......
...........
...*..*.*..
...........
......*...*
..*........
.........*.
...*.......
...........
.*.....*...
...........
....*......
......*....
*..........
...*.......
.......*...
...*.......
...........
...........
.....*...